NO ./textures/blue_wood/north_wall.xpm
C 	   1,15,150

EA ./textures/blue_wood/east_wall.xpm

SO   ./textures/blue_wood/south_wall.xpm

F 150,15,1

WE  	  ./textures/blue_wood/west_wall.xpm
			

  
11111
10001
100N1
11111