NO ./textures/blue_wood/north_wall.xpm
EA ./textures/blue_wood/east_wall.xpm
WE ./textures/blue_wood/west_wall.xpm
SO ./textures/blue_wood/south_wall.xpm

F 150,15,1
C   1,15,150


1111		1111		1111
1001		1001		1001
1001		1001		1001
1001		1001		1001
1001111111111001111111111001111111111
1000000000000000000000000000000000001
100000000000000W000000000000000000001
1111111110011111100111111111100111111
		1001	1001		1001	
		1001	1001		1001	
		1001	1001		1001	
		1001	1001		1001	
		1001	1001		1001	
		1111	1111		1111	