NO ./textures/blue_wood/north_wall.xpm
EA  	./textures/blue_wood/east_wall.xpm
WE 	./textures/blue_wood/west_wall.xpm
SO   ./textures/blue_wood/south_wall.xpm

F 	150,15,1
C   		 1,15,150


1111111111111111111111111111111111
1000000000000000000000000000000001
1000000000000000000000000000000001
1000000000111111111111110000000001
1000W000001            10000000001
10000000001            10000000001
10000000001            10000000001
10000000001            10000000001
1000000000111111111111110000000001
1000000000000000000000000000000001
1000000000000000000000000000000001
1111111111111111111111111111111111