	  NOt ./textures/blue_wood/north_wall.xpm


          EAt ./textures/blue_wood/east_wall.xpm


SOt   ./textures/blue_wood/south_wall.xpm
WEt  	  ./textures/blue_wood/west_wall.xpm
			Ft 150,15,1

    Ct 	   1,15,150
11111 11111
10001 10000
100N1 10000
11111 11111