NO ./textures/blue_wood/north_wall.xpm
SO ./textures/blue_wood/south_wall.xpm
WE ./textures/blue_wood/west_wall.xpm
EA ./textures/blue_wood/east_wall.xpm
F 100,100,100
C 0,128,128

 1111111111
1000N0000E01
100000S00001
 1111111111