NO NO NO ./textures/north_wall.xpm
EAEAEAEA ./textures/east_wall.xpm
WEWE WE WE 	  ./textures/west_wall.xpm
SO SOSOSO  ./textures/south_wall.xpm

F 150,15,1
C 	   1,15,150


1111111111111111111111111111111111
1000000000000000000000000000000001
1000000000000000000000000000000001
1000000000111111111111110000000001
10000000001            10000000001
10000000001            10000000001
10000000001            10000000001
10000000001            10000000001
1000000000111111111111110000000001
1000000000000000000000000000000001
10000000000000N0000000000000000001
1111111111111111111111111111111111