NO ./textures/blue_wood/north_wall.xpm
SO ./textures/blue_wood/south_wall.xpm
WE ./textures/blue_wood/west_wall.xpm
EA ./textures/blue_wood/east_wall.xpm
F -111,10+0,100
C 0,12-8,300

 1111111111
100000000001
100000S00001
 1111111111