	  NO ./textures/blue_wood/north_wall.xpm


          EA ./textures/blue_wood/east_wall.xpm

SO   ./textures/blue_wood/south_wall.xpm
WE   ./textures/blue_wood/west_wall.xpm
			F 150,15,1

    C    1,15,150
	
11111 111111
100011100001
100N   00001
111111111111