NO ./textures/  north_wall.xpm
EA ./textures/east_wall		.xpm
WE ./    textures/west_wall.xpm
SO ./textures/   	south_wall.xpm

F 150,15,1
C    1,15,150


1111111111111111111111111111111111
1000000000000000000000000000000001
1000000000000000000000000000000001
1000000000111111111111110000000001
10000000001            10000000001
10000000001            10000000001
10000000001            10000000001
10000000001            10000000001
1000000000111111111111110000000001
1000000000000000000000000000000001
1000000000000000000000000000000001
1111111111111111111111111111111111