	  NO ./textures/north_wall/hehe.xpm


          EA ./textures/east_wall/ughh.xpm

SO   ./textures/holla/south_wall.xpm
WE    ./umm/textures/west_wall.xpm
			F 150,15,1

    C    1,15,150
11111 11111
10001 10000
100N1 10000
11111 11111